Aaren => aroma
Aarika => bagel
Abagael => batter
Abagail => beans
Abbe => beer
Abbey => biscuit
Abbi => bread
Abbie => broth
Abby => burger
Abbye => burrito
Abigael => butter
Abigail => cake
Abigale => candy
Abra => caramel
Ada => caviar
Adah => cheese
Adaline => chili
Adan => chimichanga
Adara => chocolate
Adda => cider
Addi => cobbler
Addia => cocoa
Addie => coffee
Addy => cookie
Adel => cream
Adela => croissant
Adelaida => crumble
Adelaide => cuisine
Adele => curd
Adelheid => dessert
Adelice => dish
Adelina => drink
Adelind => eggs
Adeline => empanada
Adella => enchilada
Adelle => entree
Adena => filet
Adey => fish
Adi => flour
Adiana => foie gras
Adina => food
Adora => glaze
Adore => grill
Adoree => hamburger
Adorne => ice
Adrea => juice
Adria => ketchup
Adriaens => kitchen
Adrian => lard
Adriana => liquor